+ + + + - - - -
+ - - + + + + -
+ - - - - - + -
+ - - - - - + -
+ + + - + + + -
+ - @ @ @ - + +
+ - X X X * - +
+ + + + - - - +
- - - + + + + +