- + + + + + - -
- + - - - + + -
+ + - + @ - + +
+ - @ - - - - +
+ X - X + - - +
+ + + - * - + +
- - + - + - + -
- - + - - - + -
- - + + + + + -