- - - - - + + + +
- - - + + + - - +
- + + + - X X - +
- + - @ @ + - - +
+ + - + - + * + +
+ - - - - - - - +
+ - - - + - - - +
+ + + + + + - - +
- - - - - + + + +