- - + + + + + -
+ + + - - - + -
+ - @ - + - + +
+ - + - - X - +
+ - X - - + - +
+ + @ + X @ - +
- + * - - + + +
- + + + + + - -