- + + + + + - -
- + - - - + + -
+ + X + @ - + +
+ - @ - - - - +
+ X - X + @ - +
+ + + - * - + +
- - + - + - + -
- - + - - - + -
- - + + + + + -