- - - - - - + + + + -
+ + + + + + + - - + -
+ - - - - - - - - + -
+ - - @ - + X + - + -
+ - @ @ + + - + - + +
+ + + - X - * - - - +
- - + + + - - + - - +
- - - - + + X - - + +
- - - - - + + + + + -