- - - - + + + +
+ + + + + - - +
+ - - - $ - - +
+ - $ X + - - +
+ + - + + - + +
+ - @ - - - - +
+ - * + - - - +
+ - - + + + + +
+ + + + - - - -