- - + + + + -
- + + - - + -
+ + - - - + +
+ - - $ @ - +
+ - + - + * +
+ - - $ X - +
+ + + - - + +
- - + - - + -
- - + + + + -