+ + + + + + + +
+ - - - + - - +
+ - - - - - - +
+ + - + X - X +
+ - - - - + + +
+ - + - $ - + -
+ - @ @ + - + -
+ + + - - * + -
- - + + + + + -