- - - + + + + -
+ + + + - - + -
+ - - @ - - + +
+ - + @ + - - +
+ - - @ - - - +
+ X + + + - - +
+ X + + + + - +
+ X - * - - - +
+ + + + + + + +